17x23
111111111111111111111111
100000011111000000000001
100000010110000000000001
100000010000010000011101
100000000000010000001001
100000000000010000001001
111110011111110000000001
100000010000000000010101
100000010010000000010101
100011110011110000011101
100010000000000000000001
100010000000000000011101
100010001001000000010001
100010001001000000010001
100000001001111111111101
100000001000000000100001
111111111111111111111111